8 8
T T T T T T T L
T C T T T T L T
T T C T T L T T
T T T C L T T T
T T T L C T T T
T T L T T C T T
T L T T T T C T
L T T T T T T C
